000000000000000000000000000000
000002233000220022000332200000
000002233000220022000332200000
000000022000011110000220000000
033000022330011110033220000330
033220000331122221133000022330
000223333001122221100333322000
000003333112233332211333300000
000000000112233332211000000000
000000001122334433221100000000
332233221122335533221122332233
332233220112235532211022332233
000000000112234432211000000000
000000022001122221100220000000
000003322001122221100223300000
033223300000011110000003322330
033220000000011110000000022330
000000000000000000000000000000